1111111111111111111111111111111111111
1000000100110000000C00000000C00000C01
1000001001100011110000000000000000001
100100001C100001100C00100C0E000000001
101P00000010C001110000000000001111111
100100000000000C000000001000000001111
1111111111111111111111111111111111111