111111
100PC1
1C1001
111011
1E0001
111111