1111111111111111111111111111111111111
1000000100010000000C00000000C00000C01
1000001000000011111110000000000000001
100000000C000001101C10100C00000000001
100P00000000C001111110000000001111111
100000000000000C0000E0001000000001111
1111111111111111111111111111111111111