1111111111111111111111111111111111111
1000000100010000000C00000000C00000C01
1000001000000011111110000000000000001
101110000C000000000C00100C00000000001
101P10000000C001111110000000001111111
101110000000000C0000E0001000000001111
1111111111111111111111111111111111111