111111
100101
1C00P1
101101
100001
111111