1111111111111111
1P00000000110001
1000110000000001
1C00100110000001
10000000C0000E01
1110011100000011
1C00000000000001
1000001111100001
1C00001000000001
1000000011100001
1C000000000C0001
1001111000000001
1C00000001110001
10000000C0000C01
1000000000000001
1111111111111111
