11111111111
10100010001
10100011101
1010101P001
10111000001
10000100001
10C00000001
1000000E001
10000000001
11111111111