1111111111111111
1P00000000000001
1000111111111001
10C00000000000C1
1000111000111001
1000000000000001
1110011111000111
1000000000000001
10C00001110000C1
1110001111000111
1000000000000001
1C00000000000001
1111000111000111
1000000000000001
1000000E00000001
1111111111111111
